Topic 1,Topic 2,Topic 3,Topic 4,Topic 5,Topic 6,Topic 7,Topic 8,Topic 9,Topic 10,Topic 11,Topic 12,Topic 13,Topic 14,Topic 15,Topic 16,Topic 17,Topic 18,Topic 19,Topic 20,Topic 21,Topic 22,Topic 23,Topic 24,Topic 25,Topic 26,Topic 27,Topic 28,Topic 29
ENSG00000096088,ENSG00000197971,ENSG00000244734,ENSG00000172867,ENSG00000244734,ENSG00000121966,ENSG00000239839,ENSG00000244734,ENSG00000122304,ENSG00000175206,ENSG00000244734,ENSG00000244734,ENSG00000211594,ENSG00000042832,ENSG00000211595,ENSG00000111245,ENSG00000244734,ENSG00000143546,ENSG00000111245,ENSG00000163221,ENSG00000166819,ENSG00000225972,ENSG00000136999,ENSG00000244734,ENSG00000244734,ENSG00000132639,ENSG00000171401,ENSG00000163661,ENSG00000244734
ENSG00000211890,ENSG00000123560,ENSG00000119535,ENSG00000188508,ENSG00000158578,ENSG00000105374,ENSG00000244734,ENSG00000162747,ENSG00000175646,ENSG00000120937,ENSG00000112303,ENSG00000143546,ENSG00000211890,ENSG00000115705,ENSG00000244734,ENSG00000180209,ENSG00000169877,ENSG00000163221,ENSG00000180209,ENSG00000171051,ENSG00000187288,ENSG00000197616,ENSG00000133026,ENSG00000171051,ENSG00000169429,ENSG00000127585,ENSG00000170477,ENSG00000120708,ENSG00000249790
ENSG00000182333,ENSG00000131095,ENSG00000085265,ENSG00000186847,ENSG00000206177,ENSG00000244734,ENSG00000188404,ENSG00000163563,ENSG00000175206,ENSG00000106631,ENSG00000119535,ENSG00000163221,ENSG00000211593,ENSG00000125618,ENSG00000277632,ENSG00000109061,ENSG00000227507,ENSG00000183019,ENSG00000109061,ENSG00000188404,ENSG00000181092,ENSG00000198744,ENSG00000077943,ENSG00000163221,ENSG00000100450,ENSG00000155980,ENSG00000163209,ENSG00000107984,ENSG00000119535
ENSG00000115386,ENSG00000087250,ENSG00000274536,ENSG00000178372,ENSG00000119535,ENSG00000124102,ENSG00000143546,ENSG00000163221,ENSG00000106631,ENSG00000198336,ENSG00000171051,ENSG00000090382,ENSG00000211675,ENSG00000240237,ENSG00000211679,ENSG00000125414,ENSG00000158578,ENSG00000112303,ENSG00000196296,ENSG00000187116,ENSG00000138207,ENSG00000106631,ENSG00000173705,ENSG00000105374,ENSG00000163631,ENSG00000074317,ENSG00000143536,ENSG00000163735,ENSG00000197540
ENSG00000171345,ENSG00000091513,ENSG00000187116,ENSG00000203782,ENSG00000163221,ENSG00000115523,ENSG00000140678,ENSG00000126759,ENSG00000197616,ENSG00000197616,ENSG00000066336,ENSG00000185862,ENSG00000211896,ENSG00000136352,ENSG00000211644,ENSG00000196296,ENSG00000124102,ENSG00000244734,ENSG00000086967,ENSG00000110876,ENSG00000079435,ENSG00000134571,ENSG00000162998,ENSG00000158578,ENSG00000105374,ENSG00000121905,ENSG00000140519,ENSG00000196549,ENSG00000143546
ENSG00000184956,ENSG00000168314,ENSG00000197249,ENSG00000161634,ENSG00000000938,ENSG00000018280,ENSG00000180644,ENSG00000183019,ENSG00000111245,ENSG00000163217,ENSG00000188404,ENSG00000197405,ENSG00000211595,ENSG00000147606,ENSG00000158050,ENSG00000183091,ENSG00000126759,ENSG00000110876,ENSG00000158022,ENSG00000066336,ENSG00000257017,ENSG00000210140,ENSG00000105664,ENSG00000159339,ENSG00000211751,ENSG00000105696,ENSG00000241794,ENSG00000075073,ENSG00000085265
ENSG00000198074,ENSG00000160781,ENSG00000100985,ENSG00000159516,ENSG00000130755,ENSG00000163221,ENSG00000197249,ENSG00000121316,ENSG00000168334,ENSG00000105697,ENSG00000115523,ENSG00000110876,ENSG00000239951,ENSG00000009765,ENSG00000211900,ENSG00000105048,ENSG00000239839,ENSG00000000938,ENSG00000185482,ENSG00000103569,ENSG00000174697,ENSG00000175206,ENSG00000112214,ENSG00000271503,ENSG00000115523,ENSG00000145920,ENSG00000205420,ENSG00000224958,ENSG00000115523
ENSG00000106541,ENSG00000104833,ENSG00000143546,ENSG00000161249,ENSG00000123405,ENSG00000160213,ENSG00000187116,ENSG00000180871,ENSG00000077009,ENSG00000221986,ENSG00000158578,ENSG00000183019,ENSG00000132465,ENSG00000168878,ENSG00000211945,ENSG00000240045,ENSG00000121966,ENSG00000100365,ENSG00000125414,ENSG00000162747,ENSG00000179914,ENSG00000205678,ENSG00000167941,ENSG00000118520,ENSG00000086506,ENSG00000063180,ENSG00000160213,ENSG00000196611,ENSG00000187116
ENSG00000160181,ENSG00000160307,ENSG00000112303,ENSG00000143520,ENSG00000115956,ENSG00000100453,ENSG00000101336,ENSG00000163421,ENSG00000172399,ENSG00000187550,ENSG00000239951,ENSG00000151651,ENSG00000211598,ENSG00000283766,ENSG00000117091,ENSG00000086967,ENSG00000004939,ENSG00000185862,ENSG00000183091,ENSG00000197249,ENSG00000176194,ENSG00000168334,ENSG00000170891,ENSG00000134827,ENSG00000115085,ENSG00000104888,ENSG00000143546,ENSG00000166825,ENSG00000164047
ENSG00000016602,ENSG00000110436,ENSG00000163221,ENSG00000198854,ENSG00000143546,ENSG00000271503,ENSG00000180871,ENSG00000086506,ENSG00000118245,ENSG00000170439,ENSG00000182885,ENSG00000000938,ENSG00000241351,ENSG00000229415,ENSG00000242472,ENSG00000185482,ENSG00000090382,ENSG00000018280,ENSG00000250978,ENSG00000183019,ENSG00000151365,ENSG00000198336,ENSG00000108405,ENSG00000206177,ENSG00000172543,ENSG00000253230,ENSG00000204544,ENSG00000166923,ENSG00000172543
ENSG00000148346,ENSG00000236824,ENSG00000204482,ENSG00000105141,ENSG00000182885,ENSG00000198851,ENSG00000086506,ENSG00000128383,ENSG00000170807,ENSG00000170807,ENSG00000197405,ENSG00000140678,ENSG00000211666,ENSG00000197119,ENSG00000243466,ENSG00000143318,ENSG00000163421,ENSG00000204936,ENSG00000240045,ENSG00000163464,ENSG00000184811,ENSG00000077009,ENSG00000162267,ENSG00000204936,ENSG00000197540,ENSG00000020129,ENSG00000169474,ENSG00000181541,ENSG00000182885
ENSG00000100604,ENSG00000101200,ENSG00000197405,ENSG00000159455,ENSG00000160593,ENSG00000185862,ENSG00000104894,ENSG00000018280,ENSG00000132693,ENSG00000172399,ENSG00000239855,ENSG00000112303,ENSG00000211893,ENSG00000165409,ENSG00000104921,ENSG00000182676,ENSG00000115523,ENSG00000213654,ENSG00000196218,ENSG00000132965,ENSG00000118849,ENSG00000111245,ENSG00000130222,ENSG00000182885,ENSG00000145649,ENSG00000144834,ENSG00000121552,ENSG00000101200,ENSG00000158578
ENSG00000089356,ENSG00000118785,ENSG00000249790,ENSG00000197084,ENSG00000268903,ENSG00000198336,ENSG00000119535,ENSG00000008516,ENSG00000180209,ENSG00000158022,ENSG00000147168,ENSG00000100365,ENSG00000211897,ENSG00000185133,ENSG00000211949,ENSG00000163157,ENSG00000081237,ENSG00000101336,ENSG00000157119,ENSG00000204936,ENSG00000056998,ENSG00000183072,ENSG00000135324,ENSG00000183019,ENSG00000211899,ENSG00000172020,ENSG00000172005,ENSG00000138829,ENSG00000151651
ENSG00000105388,ENSG00000105695,ENSG00000163631,ENSG00000172551,ENSG00000099985,ENSG00000163464,ENSG00000128383,ENSG00000160255,ENSG00000171564,ENSG00000138100,ENSG00000175489,ENSG00000115956,ENSG00000211660,ENSG00000211452,ENSG00000169442,ENSG00000164879,ENSG00000100985,ENSG00000115590,ENSG00000105048,ENSG00000008516,ENSG00000136244,ENSG00000170807,ENSG00000111404,ENSG00000185862,ENSG00000102837,ENSG00000131771,ENSG00000125780,ENSG00000101447,ENSG00000185862
ENSG00000164266,ENSG00000209082,ENSG00000015285,ENSG00000244617,ENSG00000100055,ENSG00000108244,ENSG00000143226,ENSG00000008438,ENSG00000210144,ENSG00000155657,ENSG00000143119,ENSG00000018280,ENSG00000211679,ENSG00000153446,ENSG00000105246,ENSG00000120729,ENSG00000211751,ENSG00000180871,ENSG00000111046,ENSG00000244734,ENSG00000119927,ENSG00000075886,ENSG00000095713,ENSG00000100985,ENSG00000271503,ENSG00000213760,ENSG00000185873,ENSG00000260549,ENSG00000008438
ENSG00000167653,ENSG00000132702,ENSG00000163421,ENSG00000135443,ENSG00000126262,ENSG00000173110,ENSG00000115607,ENSG00000185862,ENSG00000171557,ENSG00000186439,ENSG00000158825,ENSG00000213654,ENSG00000211668,ENSG00000135480,ENSG00000211964,ENSG00000101306,ENSG00000182782,ENSG00000162747,ENSG00000182676,ENSG00000115590,ENSG00000102854,ENSG00000138100,ENSG00000164761,ENSG00000101336,ENSG00000277632,ENSG00000197971,ENSG00000186847,ENSG00000113196,ENSG00000110934
ENSG00000248144,ENSG00000168280,ENSG00000182885,ENSG00000182591,ENSG00000110876,ENSG00000172543,ENSG00000008516,ENSG00000112303,ENSG00000134571,ENSG00000168334,ENSG00000185862,ENSG00000101336,ENSG00000244437,ENSG00000184925,ENSG00000211660,ENSG00000248746,ENSG00000005844,ENSG00000182885,ENSG00000143318,ENSG00000140749,ENSG00000133317,ENSG00000124701,ENSG00000139970,ENSG00000123405,ENSG00000100427,ENSG00000105649,ENSG00000124102,ENSG00000105825,ENSG00000115590
ENSG00000189377,ENSG00000168913,ENSG00000269981,ENSG00000128422,ENSG00000111245,ENSG00000180871,ENSG00000105205,ENSG00000115271,ENSG00000171560,ENSG00000124701,ENSG00000103569,ENSG00000160255,ENSG00000243466,ENSG00000198417,ENSG00000241755,ENSG00000157119,ENSG00000100453,ENSG00000142347,ENSG00000108878,ENSG00000268734,ENSG00000163661,ENSG00000210191,ENSG00000275896,ENSG00000163563,ENSG00000158050,ENSG00000184524,ENSG00000183347,ENSG00000113739,ENSG00000066336
ENSG00000159166,ENSG00000102109,ENSG00000127084,ENSG00000204421,ENSG00000173110,ENSG00000163631,ENSG00000213654,ENSG00000115956,ENSG00000203784,ENSG00000168509,ENSG00000163993,ENSG00000269981,ENSG00000278196,ENSG00000178919,ENSG00000234883,ENSG00000214872,ENSG00000115956,ENSG00000146094,ENSG00000188176,ENSG00000231412,ENSG00000081041,ENSG00000163217,ENSG00000204983,ENSG00000143546,ENSG00000100453,ENSG00000123560,ENSG00000136689,ENSG00000149968,ENSG00000125910
ENSG00000137440,ENSG00000204655,ENSG00000169385,ENSG00000205420,ENSG00000173868,ENSG00000099985,ENSG00000163631,ENSG00000182885,ENSG00000163206,ENSG00000242349,ENSG00000143546,ENSG00000137462,ENSG00000211663,ENSG00000091137,ENSG00000275302,ENSG00000197616,ENSG00000162747,ENSG00000160255,ENSG00000163157,ENSG00000158825,ENSG00000243649,ENSG00000213578,ENSG00000186832,ENSG00000121966,ENSG00000198851,ENSG00000102109,ENSG00000057149,ENSG00000101405,ENSG00000197405
ENSG00000134812,ENSG00000136541,ENSG00000000938,ENSG00000175315,ENSG00000163563,ENSG00000211751,ENSG00000164047,ENSG00000198336,ENSG00000124701,ENSG00000134571,ENSG00000169877,ENSG00000180871,ENSG00000211648,ENSG00000259104,ENSG00000105369,ENSG00000155657,ENSG00000204936,ENSG00000143226,ENSG00000248746,ENSG00000000938,ENSG00000161905,ENSG00000134240,ENSG00000137392,ENSG00000102837,ENSG00000211666,ENSG00000133169,ENSG00000136694,ENSG00000054938,ENSG00000103569
