Topic 1
ENSG00000210196
ENSG00000229315
ENSG00000220326
ENSG00000047936
ENSG00000170162
ENSG00000164451
ENSG00000227012
ENSG00000200926
ENSG00000004809
ENSG00000146360
ENSG00000218536
ENSG00000152034
ENSG00000137251
ENSG00000112214
ENSG00000146276
ENSG00000234426
ENSG00000118434
ENSG00000135346
ENSG00000135324
ENSG00000226089
ENSG00000231533
