Topic 1,Topic 2,Topic 3,Topic 4,Topic 5,Topic 6,Topic 7,Topic 8,Topic 9,Topic 10,Topic 11,Topic 12,Topic 13,Topic 14,Topic 15,Topic 16,Topic 17,Topic 18,Topic 19,Topic 20,Topic 21,Topic 22,Topic 23,Topic 24,Topic 25,Topic 26,Topic 27,Topic 28,Topic 29
ENSG00000131095,ENSG00000104879,ENSG00000244734,ENSG00000042832,ENSG00000104879,ENSG00000204983,ENSG00000170323,ENSG00000170323,ENSG00000175206,ENSG00000115414,ENSG00000196091,ENSG00000211895,ENSG00000205420,ENSG00000139899,ENSG00000244734,ENSG00000137801,ENSG00000171401,ENSG00000234883,ENSG00000188536,ENSG00000225972,ENSG00000149591,ENSG00000133392,ENSG00000171401,ENSG00000211899,ENSG00000244734,ENSG00000111245,ENSG00000244734,ENSG00000186395,ENSG00000106624
ENSG00000197971,ENSG00000158022,ENSG00000206172,ENSG00000115705,ENSG00000105048,ENSG00000137392,ENSG00000187288,ENSG00000187288,ENSG00000106631,ENSG00000108821,ENSG00000198125,ENSG00000211890,ENSG00000186081,ENSG00000155980,ENSG00000223609,ENSG00000174807,ENSG00000170477,ENSG00000105246,ENSG00000244734,ENSG00000170323,ENSG00000115414,ENSG00000163017,ENSG00000163209,ENSG00000234883,ENSG00000188536,ENSG00000092054,ENSG00000206172,ENSG00000167768,ENSG00000149591
ENSG00000160781,ENSG00000111245,ENSG00000185201,ENSG00000125618,ENSG00000101470,ENSG00000175535,ENSG00000166819,ENSG00000166819,ENSG00000120937,ENSG00000163661,ENSG00000101470,ENSG00000162896,ENSG00000167656,ENSG00000087250,ENSG00000188536,ENSG00000087086,ENSG00000163209,ENSG00000211896,ENSG00000171051,ENSG00000120885,ENSG00000143248,ENSG00000149591,ENSG00000241794,ENSG00000143546,ENSG00000185201,ENSG00000114854,ENSG00000188536,ENSG00000172867,ENSG00000140545
ENSG00000087250,ENSG00000108515,ENSG00000163221,ENSG00000137077,ENSG00000164879,ENSG00000161634,ENSG00000173432,ENSG00000123689,ENSG00000197616,ENSG00000164692,ENSG00000239474,ENSG00000171747,ENSG00000171401,ENSG00000154146,ENSG00000059804,ENSG00000244734,ENSG00000143536,ENSG00000179344,ENSG00000223609,ENSG00000175445,ENSG00000076706,ENSG00000159176,ENSG00000203785,ENSG00000105246,ENSG00000206172,ENSG00000198125,ENSG00000223609,ENSG00000188508,ENSG00000159251
ENSG00000021300,ENSG00000101470,ENSG00000223609,ENSG00000125144,ENSG00000198125,ENSG00000091704,ENSG00000138207,ENSG00000099194,ENSG00000198336,ENSG00000120708,ENSG00000105048,ENSG00000211675,ENSG00000121552,ENSG00000111674,ENSG00000090382,ENSG00000106366,ENSG00000140519,ENSG00000105369,ENSG00000213654,ENSG00000118785,ENSG00000115380,ENSG00000130176,ENSG00000169469,ENSG00000105374,ENSG00000223609,ENSG00000104879,ENSG00000163221,ENSG00000186847,ENSG00000077943
ENSG00000160307,ENSG00000180209,ENSG00000188536,ENSG00000135480,ENSG00000130598,ENSG00000142789,ENSG00000123689,ENSG00000167676,ENSG00000159251,ENSG00000107984,ENSG00000240045,ENSG00000211677,ENSG00000186847,ENSG00000127585,ENSG00000100985,ENSG00000100979,ENSG00000160213,ENSG00000231389,ENSG00000143546,ENSG00000166819,ENSG00000188783,ENSG00000125868,ENSG00000205420,ENSG00000122862,ENSG00000143546,ENSG00000160808,ENSG00000119535,ENSG00000178372,ENSG00000136999
ENSG00000180354,ENSG00000239474,ENSG00000188404,ENSG00000160180,ENSG00000168530,ENSG00000168925,ENSG00000167676,ENSG00000162444,ENSG00000118194,ENSG00000106366,ENSG00000114854,ENSG00000211896,ENSG00000172867,ENSG00000132639,ENSG00000206172,ENSG00000115414,ENSG00000205420,ENSG00000132465,ENSG00000163464,ENSG00000164692,ENSG00000125868,ENSG00000065534,ENSG00000186081,ENSG00000111335,ENSG00000163221,ENSG00000105048,ENSG00000013306,ENSG00000203782,ENSG00000049540
ENSG00000091513,ENSG00000186395,ENSG00000011600,ENSG00000185133,ENSG00000109061,ENSG00000189334,ENSG00000079435,ENSG00000163661,ENSG00000129991,ENSG00000196549,ENSG00000168530,ENSG00000132465,ENSG00000175793,ENSG00000179456,ENSG00000188404,ENSG00000163661,ENSG00000241794,ENSG00000187608,ENSG00000105374,ENSG00000187288,ENSG00000171223,ENSG00000182253,ENSG00000143536,ENSG00000188404,ENSG00000011600,ENSG00000173991,ENSG00000112303,ENSG00000161634,ENSG00000115457
ENSG00000101405,ENSG00000130595,ENSG00000158869,ENSG00000197119,ENSG00000173991,ENSG00000168928,ENSG00000167588,ENSG00000138207,ENSG00000148677,ENSG00000137801,ENSG00000185482,ENSG00000211679,ENSG00000196754,ENSG00000110931,ENSG00000204936,ENSG00000111341,ENSG00000169474,ENSG00000012124,ENSG00000116701,ENSG00000087086,ENSG00000167641,ENSG00000072163,ENSG00000170477,ENSG00000158050,ENSG00000111348,ENSG00000164879,ENSG00000171051,ENSG00000161249,ENSG00000175206
ENSG00000105290,ENSG00000164879,ENSG00000077984,ENSG00000198417,ENSG00000120729,ENSG00000205420,ENSG00000135218,ENSG00000169692,ENSG00000134571,ENSG00000163359,ENSG00000156885,ENSG00000211893,ENSG00000189334,ENSG00000152154,ENSG00000158869,ENSG00000115380,ENSG00000121552,ENSG00000064886,ENSG00000119535,ENSG00000143387,ENSG00000121898,ENSG00000154330,ENSG00000140519,ENSG00000104951,ENSG00000158869,ENSG00000129991,ENSG00000077984,ENSG00000178934,ENSG00000143248
ENSG00000168309,ENSG00000115414,ENSG00000163563,ENSG00000076864,ENSG00000156885,ENSG00000170835,ENSG00000169710,ENSG00000079435,ENSG00000160808,ENSG00000106333,ENSG00000177791,ENSG00000164816,ENSG00000169469,ENSG00000089199,ENSG00000239839,ENSG00000188536,ENSG00000143546,ENSG00000137959,ENSG00000110876,ENSG00000159189,ENSG00000106366,ENSG00000116741,ENSG00000124102,ENSG00000226979,ENSG00000136167,ENSG00000077522,ENSG00000143546,ENSG00000189001,ENSG00000259384
ENSG00000118785,ENSG00000172403,ENSG00000187116,ENSG00000205517,ENSG00000165887,ENSG00000153002,ENSG00000175445,ENSG00000197766,ENSG00000173991,ENSG00000166825,ENSG00000183091,ENSG00000102837,ENSG00000163209,ENSG00000185615,ENSG00000185201,ENSG00000166819,ENSG00000172005,ENSG00000226979,ENSG00000169180,ENSG00000237973,ENSG00000186340,ENSG00000167641,ENSG00000169474,ENSG00000179344,ENSG00000143119,ENSG00000159173,ENSG00000162747,ENSG00000244617,ENSG00000188783
ENSG00000155980,ENSG00000183386,ENSG00000142347,ENSG00000168878,ENSG00000130595,ENSG00000170890,ENSG00000169692,ENSG00000184557,ENSG00000092054,ENSG00000103888,ENSG00000130595,ENSG00000211892,ENSG00000125780,ENSG00000143847,ENSG00000101336,ENSG00000173918,ENSG00000135046,ENSG00000158457,ENSG00000111348,ENSG00000204388,ENSG00000119681,ENSG00000023902,ENSG00000167656,ENSG00000105369,ENSG00000162551,ENSG00000156885,ENSG00000188404,ENSG00000204421,ENSG00000087086
ENSG00000151552,ENSG00000168530,ENSG00000100985,ENSG00000050767,ENSG00000197893,ENSG00000179751,ENSG00000042832,ENSG00000087086,ENSG00000077009,ENSG00000168542,ENSG00000180209,ENSG00000115386,ENSG00000143556,ENSG00000020129,ENSG00000162551,ENSG00000136960,ENSG00000125780,ENSG00000211675,ENSG00000100985,ENSG00000168309,ENSG00000170955,ENSG00000132329,ENSG00000121552,ENSG00000231389,ENSG00000162511,ENSG00000101470,ENSG00000136167,ENSG00000175315,ENSG00000133392
ENSG00000168913,ENSG00000068976,ENSG00000211899,ENSG00000088836,ENSG00000180209,ENSG00000186081,ENSG00000099194,ENSG00000136244,ENSG00000198125,ENSG00000148926,ENSG00000125414,ENSG00000160180,ENSG00000087086,ENSG00000112139,ENSG00000163221,ENSG00000135218,ENSG00000143369,ENSG00000157601,ENSG00000239839,ENSG00000099864,ENSG00000180139,ENSG00000076706,ENSG00000175793,ENSG00000007312,ENSG00000115590,ENSG00000165887,ENSG00000163464,ENSG00000163347,ENSG00000111341
ENSG00000154277,ENSG00000185482,ENSG00000197249,ENSG00000187266,ENSG00000086967,ENSG00000158516,ENSG00000162444,ENSG00000119927,ENSG00000105697,ENSG00000113083,ENSG00000109061,ENSG00000139540,ENSG00000171346,ENSG00000104435,ENSG00000087086,ENSG00000049323,ENSG00000136689,ENSG00000138623,ENSG00000188404,ENSG00000158869,ENSG00000087086,ENSG00000075073,ENSG00000160213,ENSG00000112303,ENSG00000122862,ENSG00000143549,ENSG00000008516,ENSG00000172551,ENSG00000185201
ENSG00000154146,ENSG00000086967,ENSG00000239839,ENSG00000054690,ENSG00000111245,ENSG00000167656,ENSG00000160180,ENSG00000019169,ENSG00000156885,ENSG00000105825,ENSG00000170290,ENSG00000155850,ENSG00000168542,ENSG00000139182,ENSG00000143119,ENSG00000173369,ENSG00000189334,ENSG00000111331,ENSG00000115590,ENSG00000131771,ENSG00000151468,ENSG00000172403,ENSG00000165272,ENSG00000110876,ENSG00000066336,ENSG00000168530,ENSG00000239839,ENSG00000112378,ENSG00000118729
ENSG00000130203,ENSG00000109061,ENSG00000090382,ENSG00000174640,ENSG00000148677,ENSG00000219073,ENSG00000132170,ENSG00000167772,ENSG00000050165,ENSG00000164932,ENSG00000130598,ENSG00000042832,ENSG00000178934,ENSG00000162706,ENSG00000169429,ENSG00000187288,ENSG00000124102,ENSG00000104951,ENSG00000206172,ENSG00000007237,ENSG00000064205,ENSG00000153179,ENSG00000143546,ENSG00000163563,ENSG00000197249,ENSG00000120729,ENSG00000187116,ENSG00000096696,ENSG00000049323
ENSG00000131771,ENSG00000154553,ENSG00000162551,ENSG00000152804,ENSG00000125414,ENSG00000124466,ENSG00000157150,ENSG00000173432,ENSG00000078114,ENSG00000166923,ENSG00000086967,ENSG00000166920,ENSG00000186395,ENSG00000131584,ENSG00000162747,ENSG00000120708,ENSG00000169509,ENSG00000139193,ENSG00000008438,ENSG00000132561,ENSG00000115738,ENSG00000135269,ENSG00000186832,ENSG00000172543,ENSG00000177105,ENSG00000077009,ENSG00000163631,ENSG00000196407,ENSG00000133026
ENSG00000137285,ENSG00000167768,ENSG00000162511,ENSG00000232442,ENSG00000159173,ENSG00000175793,ENSG00000106484,ENSG00000124253,ENSG00000111341,ENSG00000091986,ENSG00000158022,ENSG00000117472,ENSG00000172551,ENSG00000130294,ENSG00000028137,ENSG00000034971,ENSG00000165474,ENSG00000011590,ENSG00000100365,ENSG00000163815,ENSG00000072952,ENSG00000077157,ENSG00000125780,ENSG00000137959,ENSG00000239839,ENSG00000130598,ENSG00000128340,ENSG00000181458,ENSG00000120885
ENSG00000176533,ENSG00000164309,ENSG00000008516,ENSG00000140263,ENSG00000182676,ENSG00000186847,ENSG00000122378,ENSG00000163815,ENSG00000174437,ENSG00000260549,ENSG00000173991,ENSG00000104267,ENSG00000188508,ENSG00000073670,ENSG00000158825,ENSG00000198959,ENSG00000105427,ENSG00000198502,ENSG00000158869,ENSG00000164949,ENSG00000168386,ENSG00000106772,ENSG00000165474,ENSG00000223609,ENSG00000101336,ENSG00000118194,ENSG00000163563,ENSG00000081277,ENSG00000112562
