Topic 1,Topic 2,Topic 3,Topic 4,Topic 5,Topic 6,Topic 7,Topic 8,Topic 9,Topic 10,Topic 11,Topic 12,Topic 13,Topic 14,Topic 15,Topic 16,Topic 17,Topic 18,Topic 19,Topic 20,Topic 21,Topic 22,Topic 23,Topic 24,Topic 25,Topic 26
ENSG00000175206,ENSG00000160180,ENSG00000244734,ENSG00000198125,ENSG00000114854,ENSG00000167768,ENSG00000170323,ENSG00000115414,ENSG00000104879,ENSG00000111341,ENSG00000042832,ENSG00000111245,ENSG00000131095,ENSG00000131095,ENSG00000244734,ENSG00000115414,ENSG00000171401,ENSG00000211890,ENSG00000211896,ENSG00000115705,ENSG00000175206,ENSG00000133392,ENSG00000167768,ENSG00000244734,ENSG00000244734,ENSG00000115705
ENSG00000120937,ENSG00000042832,ENSG00000188536,ENSG00000114854,ENSG00000198125,ENSG00000186395,ENSG00000187288,ENSG00000164692,ENSG00000105048,ENSG00000106624,ENSG00000125618,ENSG00000105048,ENSG00000132639,ENSG00000197971,ENSG00000188536,ENSG00000087086,ENSG00000170477,ENSG00000171747,ENSG00000211899,ENSG00000042832,ENSG00000106631,ENSG00000163017,ENSG00000186395,ENSG00000170323,ENSG00000188536,ENSG00000042832
ENSG00000197616,ENSG00000119888,ENSG00000206172,ENSG00000148677,ENSG00000105048,ENSG00000172867,ENSG00000166819,ENSG00000108821,ENSG00000111245,ENSG00000106366,ENSG00000125144,ENSG00000112096,ENSG00000087250,ENSG00000154146,ENSG00000223609,ENSG00000168542,ENSG00000163209,ENSG00000162896,ENSG00000211897,ENSG00000125618,ENSG00000198336,ENSG00000149591,ENSG00000172867,ENSG00000188536,ENSG00000206172,ENSG00000135480
ENSG00000198336,ENSG00000125618,ENSG00000163221,ENSG00000129991,ENSG00000168530,ENSG00000161634,ENSG00000138207,ENSG00000163661,ENSG00000160808,ENSG00000143248,ENSG00000054690,ENSG00000168530,ENSG00000197971,ENSG00000087250,ENSG00000206172,ENSG00000148926,ENSG00000143536,ENSG00000102837,ENSG00000211892,ENSG00000185133,ENSG00000118194,ENSG00000159176,ENSG00000161634,ENSG00000185201,ENSG00000223609,ENSG00000197119
ENSG00000106631,ENSG00000137077,ENSG00000143546,ENSG00000101210,ENSG00000164879,ENSG00000188508,ENSG00000173432,ENSG00000106366,ENSG00000148677,ENSG00000145423,ENSG00000115705,ENSG00000164879,ENSG00000104833,ENSG00000132639,ENSG00000239839,ENSG00000145423,ENSG00000140519,ENSG00000211895,ENSG00000211890,ENSG00000167549,ENSG00000197616,ENSG00000130176,ENSG00000188508,ENSG00000143546,ENSG00000239839,ENSG00000125618
ENSG00000104879,ENSG00000125144,ENSG00000223609,ENSG00000104879,ENSG00000111245,ENSG00000175793,ENSG00000123689,ENSG00000120708,ENSG00000129991,ENSG00000115380,ENSG00000160180,ENSG00000099875,ENSG00000135916,ENSG00000160781,ENSG00000185201,ENSG00000164692,ENSG00000241794,ENSG00000170421,ENSG00000211895,ENSG00000131095,ENSG00000198125,ENSG00000125868,ENSG00000205420,ENSG00000223609,ENSG00000013306,ENSG00000128928
ENSG00000148677,ENSG00000054690,ENSG00000239839,ENSG00000173991,ENSG00000173991,ENSG00000205420,ENSG00000167676,ENSG00000107984,ENSG00000092054,ENSG00000168542,ENSG00000076864,ENSG00000158022,ENSG00000074317,ENSG00000160307,ENSG00000087086,ENSG00000160180,ENSG00000160213,ENSG00000211675,ENSG00000211675,ENSG00000125144,ENSG00000159251,ENSG00000111341,ENSG00000169469,ENSG00000136167,ENSG00000163221,ENSG00000174640
ENSG00000159251,ENSG00000117472,ENSG00000103569,ENSG00000197616,ENSG00000160808,ENSG00000167656,ENSG00000197766,ENSG00000137801,ENSG00000159251,ENSG00000173372,ENSG00000104324,ENSG00000196091,ENSG00000101405,ENSG00000154277,ENSG00000158869,ENSG00000170955,ENSG00000205420,ENSG00000104267,ENSG00000211893,ENSG00000198417,ENSG00000156885,ENSG00000167641,ENSG00000121552,ENSG00000072818,ENSG00000198858,ENSG00000185133
ENSG00000129991,ENSG00000115705,ENSG00000013306,ENSG00000118194,ENSG00000156885,ENSG00000169469,ENSG00000079435,ENSG00000196549,ENSG00000101470,ENSG00000049540,ENSG00000185133,ENSG00000166592,ENSG00000168913,ENSG00000180354,ENSG00000163221,ENSG00000106333,ENSG00000169474,ENSG00000117472,ENSG00000105369,ENSG00000169129,ENSG00000114854,ENSG00000182253,ENSG00000171401,ENSG00000213654,ENSG00000173868,ENSG00000111057
ENSG00000077009,ENSG00000076864,ENSG00000211899,ENSG00000087086,ENSG00000092054,ENSG00000161249,ENSG00000135218,ENSG00000163359,ENSG00000196091,ENSG00000112562,ENSG00000119888,ENSG00000239474,ENSG00000184524,ENSG00000155980,ENSG00000011600,ENSG00000163661,ENSG00000172005,ENSG00000176387,ENSG00000234883,ENSG00000120885,ENSG00000173991,ENSG00000065534,ENSG00000169509,ENSG00000077984,ENSG00000008438,ENSG00000205517
ENSG00000114854,ENSG00000262877,ENSG00000077984,ENSG00000175206,ENSG00000177791,ENSG00000178372,ENSG00000169710,ENSG00000168542,ENSG00000175445,ENSG00000173369,ENSG00000215845,ENSG00000177791,ENSG00000155980,ENSG00000063180,ENSG00000111348,ENSG00000198542,ENSG00000121552,ENSG00000115386,ENSG00000105246,ENSG00000197119,ENSG00000129991,ENSG00000132329,ENSG00000167656,ENSG00000117091,ENSG00000162747,ENSG00000132561
ENSG00000105697,ENSG00000137857,ENSG00000115590,ENSG00000156885,ENSG00000125414,ENSG00000169509,ENSG00000169692,ENSG00000106333,ENSG00000180209,ENSG00000077943,ENSG00000168878,ENSG00000183091,ENSG00000178531,ENSG00000021300,ENSG00000025708,ENSG00000166923,ENSG00000143546,ENSG00000155850,ENSG00000226979,ENSG00000197971,ENSG00000121769,ENSG00000143248,ENSG00000163209,ENSG00000227507,ENSG00000249790,ENSG00000125144
ENSG00000092054,ENSG00000185133,ENSG00000188404,ENSG00000170290,ENSG00000196091,ENSG00000172551,ENSG00000167588,ENSG00000091986,ENSG00000114854,ENSG00000149591,ENSG00000197766,ENSG00000125414,ENSG00000139899,ENSG00000127585,ENSG00000196565,ENSG00000130508,ENSG00000125780,ENSG00000166920,ENSG00000211677,ENSG00000160180,ENSG00000134571,ENSG00000076706,ENSG00000189334,ENSG00000105374,ENSG00000087086,ENSG00000158106
ENSG00000170290,ENSG00000115112,ENSG00000162551,ENSG00000129170,ENSG00000158022,ENSG00000203782,ENSG00000162444,ENSG00000164932,ENSG00000164879,ENSG00000162998,ENSG00000132561,ENSG00000172403,ENSG00000129244,ENSG00000091513,ENSG00000115590,ENSG00000111341,ENSG00000135046,ENSG00000172023,ENSG00000012124,ENSG00000111057,ENSG00000101210,ENSG00000154330,ENSG00000161249,ENSG00000151651,ENSG00000115590,ENSG00000101670
ENSG00000173991,ENSG00000215252,ENSG00000018280,ENSG00000111341,ENSG00000239474,ENSG00000268751,ENSG00000099194,ENSG00000113083,ENSG00000106631,ENSG00000140092,ENSG00000101230,ENSG00000092054,ENSG00000105696,ENSG00000105290,ENSG00000162551,ENSG00000160307,ENSG00000124102,ENSG00000139540,ENSG00000139193,ENSG00000168878,ENSG00000120937,ENSG00000188783,ENSG00000178372,ENSG00000135046,ENSG00000162551,ENSG00000198417
ENSG00000198959,ENSG00000167972,ENSG00000059804,ENSG00000134571,ENSG00000183091,ENSG00000181458,ENSG00000175445,ENSG00000105825,ENSG00000130595,ENSG00000170323,ENSG00000131037,ENSG00000004799,ENSG00000131771,ENSG00000168309,ENSG00000107738,ENSG00000164761,ENSG00000189334,ENSG00000119888,ENSG00000179344,ENSG00000135480,ENSG00000131730,ENSG00000072163,ENSG00000143556,ENSG00000115523,ENSG00000172232,ENSG00000137077
ENSG00000166831,ENSG00000101443,ENSG00000110876,ENSG00000105048,ENSG00000159173,ENSG00000143556,ENSG00000106484,ENSG00000103888,ENSG00000197616,ENSG00000182871,ENSG00000140263,ENSG00000164309,ENSG00000105649,ENSG00000109107,ENSG00000100504,ENSG00000099194,ENSG00000143369,ENSG00000164266,ENSG00000157601,ENSG00000088836,ENSG00000104879,ENSG00000023902,ENSG00000175793,ENSG00000121966,ENSG00000163464,ENSG00000173334
ENSG00000198125,ENSG00000204580,ENSG00000197249,ENSG00000159251,ENSG00000165887,ENSG00000204421,ENSG00000157150,ENSG00000142552,ENSG00000168530,ENSG00000049323,ENSG00000197119,ENSG00000159173,ENSG00000127585,ENSG00000104435,ENSG00000142657,ENSG00000118785,ENSG00000136689,ENSG00000211677,ENSG00000007312,ENSG00000050767,ENSG00000077009,ENSG00000171223,ENSG00000203782,ENSG00000102879,ENSG00000011600,ENSG00000205336
ENSG00000197893,ENSG00000169129,ENSG00000142347,ENSG00000160808,ENSG00000143318,ENSG00000169474,ENSG00000119927,ENSG00000166825,ENSG00000108515,ENSG00000136999,ENSG00000189334,ENSG00000196218,ENSG00000105290,ENSG00000108387,ENSG00000122862,ENSG00000042832,ENSG00000105427,ENSG00000121900,ENSG00000231389,ENSG00000087086,ENSG00000105697,ENSG00000103710,ENSG00000143536,ENSG00000188404,ENSG00000119535,ENSG00000140263
ENSG00000108515,ENSG00000181885,ENSG00000269981,ENSG00000239474,ENSG00000068976,ENSG00000165272,ENSG00000147872,ENSG00000149257,ENSG00000239474,ENSG00000144476,ENSG00000035664,ENSG00000240045,ENSG00000020129,ENSG00000105696,ENSG00000116741,ENSG00000131459,ENSG00000169509,ENSG00000175793,ENSG00000104951,ENSG00000187260,ENSG00000036448,ENSG00000077157,ENSG00000125780,ENSG00000167676,ENSG00000112303,ENSG00000179832
ENSG00000077522,ENSG00000137726,ENSG00000121316,ENSG00000106631,ENSG00000156804,ENSG00000171346,ENSG00000184113,ENSG00000198542,ENSG00000156885,ENSG00000173267,ENSG00000137857,ENSG00000068976,ENSG00000130294,ENSG00000137285,ENSG00000130755,ENSG00000119681,ENSG00000165474,ENSG00000128298,ENSG00000240065,ENSG00000187535,ENSG00000122367,ENSG00000115738,ENSG00000172551,ENSG00000111679,ENSG00000147454,ENSG00000128944
