Topic 1,Topic 2,Topic 3,Topic 4,Topic 5,Topic 6,Topic 7,Topic 8,Topic 9,Topic 10,Topic 11,Topic 12,Topic 13,Topic 14,Topic 15,Topic 16,Topic 17,Topic 18,Topic 19,Topic 20,Topic 21,Topic 22,Topic 23,Topic 24,Topic 25,Topic 26,Topic 27,Topic 28,Topic 29,Topic 30,Topic 31,Topic 32,Topic 33,Topic 34,Topic 35,Topic 36,Topic 37,Topic 38,Topic 39,Topic 40,Topic 41,Topic 42,Topic 43,Topic 44,Topic 45,Topic 46,Topic 47,Topic 48,Topic 49,Topic 50
ENSG00000170323,ENSG00000125618,ENSG00000158869,ENSG00000042832,ENSG00000104879,ENSG00000178372,ENSG00000170323,ENSG00000211896,ENSG00000087086,ENSG00000108821,ENSG00000170323,ENSG00000211890,ENSG00000132639,ENSG00000160307,ENSG00000170323,ENSG00000160180,ENSG00000170477,ENSG00000178372,ENSG00000171401,ENSG00000131095,ENSG00000042832,ENSG00000163017,ENSG00000171401,ENSG00000211890,ENSG00000211899,ENSG00000108821,ENSG00000244734,ENSG00000042832,ENSG00000175206,ENSG00000198417,ENSG00000186395,ENSG00000111341,ENSG00000087086,ENSG00000130598,ENSG00000167768,ENSG00000131095,ENSG00000108821,ENSG00000111245,ENSG00000106366,ENSG00000167676,ENSG00000106366,ENSG00000161634,ENSG00000125618,ENSG00000111245,ENSG00000175206,ENSG00000111341,ENSG00000175206,ENSG00000170323,ENSG00000173432,ENSG00000111245
ENSG00000211897,ENSG00000042832,ENSG00000244734,ENSG00000205517,ENSG00000101470,ENSG00000186847,ENSG00000087086,ENSG00000211892,ENSG00000120885,ENSG00000164692,ENSG00000104879,ENSG00000211895,ENSG00000155980,ENSG00000154146,ENSG00000187288,ENSG00000170323,ENSG00000171401,ENSG00000186847,ENSG00000211895,ENSG00000197971,ENSG00000205517,ENSG00000133392,ENSG00000170477,ENSG00000171747,ENSG00000234883,ENSG00000163661,ENSG00000188536,ENSG00000197971,ENSG00000106631,ENSG00000185133,ENSG00000167768,ENSG00000149591,ENSG00000115705,ENSG00000239474,ENSG00000186081,ENSG00000087250,ENSG00000120708,ENSG00000092054,ENSG00000244734,ENSG00000173432,ENSG00000164692,ENSG00000167768,ENSG00000042832,ENSG00000173991,ENSG00000106631,ENSG00000145423,ENSG00000104879,ENSG00000099194,ENSG00000099194,ENSG00000160808
ENSG00000211896,ENSG00000115705,ENSG00000188536,ENSG00000173334,ENSG00000180209,ENSG00000167768,ENSG00000123689,ENSG00000211893,ENSG00000173432,ENSG00000163661,ENSG00000115414,ENSG00000171747,ENSG00000087250,ENSG00000111674,ENSG00000244734,ENSG00000108821,ENSG00000163209,ENSG00000167768,ENSG00000163209,ENSG00000160307,ENSG00000054690,ENSG00000159176,ENSG00000163209,ENSG00000162896,ENSG00000122862,ENSG00000164692,ENSG00000206172,ENSG00000186847,ENSG00000104879,ENSG00000042832,ENSG00000172867,ENSG00000115457,ENSG00000137077,ENSG00000196091,ENSG00000161249,ENSG00000127585,ENSG00000186847,ENSG00000160808,ENSG00000115414,ENSG00000079435,ENSG00000149591,ENSG00000188508,ENSG00000160180,ENSG00000121769,ENSG00000197616,ENSG00000144476,ENSG00000198125,ENSG00000115705,ENSG00000166819,ENSG00000114854
ENSG00000087086,ENSG00000198417,ENSG00000059804,ENSG00000155660,ENSG00000168530,ENSG00000188508,ENSG00000197766,ENSG00000211675,ENSG00000170323,ENSG00000168542,ENSG00000173432,ENSG00000162896,ENSG00000197971,ENSG00000160781,ENSG00000173432,ENSG00000164442,ENSG00000140519,ENSG00000175535,ENSG00000171345,ENSG00000021300,ENSG00000137364,ENSG00000130176,ENSG00000143546,ENSG00000211895,ENSG00000105246,ENSG00000149257,ENSG00000223609,ENSG00000155980,ENSG00000198125,ENSG00000115705,ENSG00000186081,ENSG00000136999,ENSG00000160180,ENSG00000198125,ENSG00000178372,ENSG00000132639,ENSG00000186081,ENSG00000129991,ENSG00000185201,ENSG00000197766,ENSG00000125868,ENSG00000171476,ENSG00000185133,ENSG00000105048,ENSG00000120937,ENSG00000076706,ENSG00000170290,ENSG00000119888,ENSG00000079435,ENSG00000092054
ENSG00000211895,ENSG00000088836,ENSG00000011600,ENSG00000050767,ENSG00000130595,ENSG00000096696,ENSG00000162444,ENSG00000211897,ENSG00000111341,ENSG00000106333,ENSG00000187288,ENSG00000176387,ENSG00000104888,ENSG00000174684,ENSG00000166819,ENSG00000120885,ENSG00000143536,ENSG00000186081,ENSG00000087086,ENSG00000091513,ENSG00000143333,ENSG00000149591,ENSG00000140519,ENSG00000171345,ENSG00000105369,ENSG00000115414,ENSG00000239839,ENSG00000054690,ENSG00000173991,ENSG00000125618,ENSG00000161249,ENSG00000106624,ENSG00000042832,ENSG00000101470,ENSG00000189001,ENSG00000155980,ENSG00000163661,ENSG00000118194,ENSG00000188536,ENSG00000166819,ENSG00000108821,ENSG00000159763,ENSG00000125144,ENSG00000168530,ENSG00000198336,ENSG00000170323,ENSG00000173991,ENSG00000135480,ENSG00000167676,ENSG00000198125
ENSG00000187288,ENSG00000125144,ENSG00000170458,ENSG00000143333,ENSG00000105048,ENSG00000169469,ENSG00000187288,ENSG00000211895,ENSG00000169692,ENSG00000143387,ENSG00000042832,ENSG00000104267,ENSG00000168280,ENSG00000063180,ENSG00000123689,ENSG00000164692,ENSG00000172005,ENSG00000165272,ENSG00000225972,ENSG00000101405,ENSG00000117472,ENSG00000182253,ENSG00000143536,ENSG00000164816,ENSG00000226979,ENSG00000163359,ENSG00000163221,ENSG00000119888,ENSG00000114854,ENSG00000167371,ENSG00000188508,ENSG00000133392,ENSG00000125144,ENSG00000114854,ENSG00000042832,ENSG00000020129,ENSG00000106366,ENSG00000198125,ENSG00000137801,ENSG00000170323,ENSG00000142552,ENSG00000203782,ENSG00000152804,ENSG00000092054,ENSG00000159251,ENSG00000188783,ENSG00000156885,ENSG00000115457,ENSG00000170323,ENSG00000156885
ENSG00000166819,ENSG00000197119,ENSG00000143119,ENSG00000145050,ENSG00000130598,ENSG00000112378,ENSG00000130600,ENSG00000211677,ENSG00000166819,ENSG00000115414,ENSG00000135218,ENSG00000119888,ENSG00000171401,ENSG00000197971,ENSG00000167676,ENSG00000115414,ENSG00000160213,ENSG00000137392,ENSG00000079385,ENSG00000154146,ENSG00000174640,ENSG00000065534,ENSG00000160213,ENSG00000172016,ENSG00000211895,ENSG00000148926,ENSG00000119535,ENSG00000174326,ENSG00000129991,ENSG00000065717,ENSG00000126233,ENSG00000159176,ENSG00000168878,ENSG00000240045,ENSG00000163347,ENSG00000109107,ENSG00000087086,ENSG00000114854,ENSG00000122862,ENSG00000187288,ENSG00000204262,ENSG00000189001,ENSG00000197457,ENSG00000156885,ENSG00000148677,ENSG00000180139,ENSG00000159251,ENSG00000004799,ENSG00000187288,ENSG00000239474
ENSG00000115705,ENSG00000160180,ENSG00000162511,ENSG00000035664,ENSG00000177791,ENSG00000186081,ENSG00000099194,ENSG00000172724,ENSG00000197766,ENSG00000105472,ENSG00000163359,ENSG00000170421,ENSG00000108309,ENSG00000154277,ENSG00000175445,ENSG00000125144,ENSG00000135046,ENSG00000203785,ENSG00000042832,ENSG00000105290,ENSG00000168878,ENSG00000154330,ENSG00000241794,ENSG00000115386,ENSG00000231389,ENSG00000164932,ENSG00000185201,ENSG00000175130,ENSG00000170290,ENSG00000105696,ENSG00000188505,ENSG00000140545,ENSG00000101443,ENSG00000183091,ENSG00000175793,ENSG00000130203,ENSG00000168542,ENSG00000105048,ENSG00000171223,ENSG00000099194,ENSG00000111341,ENSG00000178934,ENSG00000183036,ENSG00000160808,ENSG00000118194,ENSG00000143248,ENSG00000114854,ENSG00000058404,ENSG00000169710,ENSG00000109061
ENSG00000211677,ENSG00000050767,ENSG00000107738,ENSG00000174640,ENSG00000068976,ENSG00000169474,ENSG00000062282,ENSG00000211890,ENSG00000092054,ENSG00000164932,ENSG00000163661,ENSG00000166920,ENSG00000105290,ENSG00000139899,ENSG00000138207,ENSG00000120708,ENSG00000241794,ENSG00000189001,ENSG00000170477,ENSG00000135916,ENSG00000092758,ENSG00000075073,ENSG00000186847,ENSG00000172023,ENSG00000211896,ENSG00000105825,ENSG00000077984,ENSG00000105290,ENSG00000120937,ENSG00000054690,ENSG00000178934,ENSG00000133026,ENSG00000169242,ENSG00000136717,ENSG00000203785,ENSG00000154277,ENSG00000147872,ENSG00000159251,ENSG00000111348,ENSG00000135218,ENSG00000163359,ENSG00000172551,ENSG00000198417,ENSG00000239474,ENSG00000077009,ENSG00000136999,ENSG00000239474,ENSG00000170525,ENSG00000087086,ENSG00000101470
ENSG00000004799,ENSG00000076864,ENSG00000136167,ENSG00000169116,ENSG00000196296,ENSG00000105427,ENSG00000004799,ENSG00000132465,ENSG00000137801,ENSG00000148926,ENSG00000169710,ENSG00000117472,ENSG00000154146,ENSG00000130294,ENSG00000162444,ENSG00000106333,ENSG00000143369,ENSG00000161634,ENSG00000148346,ENSG00000151552,ENSG00000187266,ENSG00000111341,ENSG00000121552,ENSG00000155850,ENSG00000012124,ENSG00000137804,ENSG00000090382,ENSG00000132698,ENSG00000077522,ENSG00000154146,ENSG00000175793,ENSG00000115380,ENSG00000163017,ENSG00000101210,ENSG00000178934,ENSG00000074317,ENSG00000112378,ENSG00000134571,ENSG00000171051,ENSG00000169710,ENSG00000198542,ENSG00000186395,ENSG00000101443,ENSG00000196091,ENSG00000134571,ENSG00000115457,ENSG00000122367,ENSG00000169710,ENSG00000197766,ENSG00000121769
ENSG00000167588,ENSG00000183036,ENSG00000122862,ENSG00000111341,ENSG00000109061,ENSG00000203782,ENSG00000138207,ENSG00000211679,ENSG00000175445,ENSG00000163359,ENSG00000198125,ENSG00000132465,ENSG00000185615,ENSG00000101405,ENSG00000163221,ENSG00000125740,ENSG00000121552,ENSG00000204983,ENSG00000019102,ENSG00000180354,ENSG00000175265,ENSG00000072163,ENSG00000169474,ENSG00000139540,ENSG00000111348,ENSG00000166825,ENSG00000162747,ENSG00000134324,ENSG00000156885,ENSG00000168878,ENSG00000203782,ENSG00000122176,ENSG00000225972,ENSG00000185482,ENSG00000184292,ENSG00000180354,ENSG00000189001,ENSG00000159173,ENSG00000115380,ENSG00000169692,ENSG00000163661,ENSG00000186847,ENSG00000088881,ENSG00000177791,ENSG00000129991,ENSG00000173918,ENSG00000121769,ENSG00000137801,ENSG00000169692,ENSG00000104879
ENSG00000211893,ENSG00000116883,ENSG00000213654,ENSG00000167549,ENSG00000125414,ENSG00000189001,ENSG00000135218,ENSG00000211899,ENSG00000171223,ENSG00000123975,ENSG00000182871,ENSG00000155850,ENSG00000124507,ENSG00000173786,ENSG00000005249,ENSG00000143387,ENSG00000169474,ENSG00000184292,ENSG00000162896,ENSG00000104833,ENSG00000152804,ENSG00000125868,ENSG00000189334,ENSG00000132465,ENSG00000179344,ENSG00000175592,ENSG00000171051,ENSG00000076706,ENSG00000197893,ENSG00000168743,ENSG00000165272,ENSG00000049540,ENSG00000164056,ENSG00000104879,ENSG00000112378,ENSG00000105696,ENSG00000115414,ENSG00000168530,ENSG00000111341,ENSG00000175445,ENSG00000186340,ENSG00000203785,ENSG00000115705,ENSG00000104879,ENSG00000105697,ENSG00000149591,ENSG00000118194,ENSG00000042832,ENSG00000134339,ENSG00000108515
ENSG00000138207,ENSG00000185133,ENSG00000111348,ENSG00000127418,ENSG00000108515,ENSG00000184292,ENSG00000173432,ENSG00000105369,ENSG00000187288,ENSG00000174807,ENSG00000188783,ENSG00000128311,ENSG00000185201,ENSG00000152154,ENSG00000099194,ENSG00000184557,ENSG00000189334,ENSG00000091704,ENSG00000176387,ENSG00000078804,ENSG00000262877,ENSG00000023902,ENSG00000169469,ENSG00000135916,ENSG00000128340,ENSG00000120708,ENSG00000163464,ENSG00000149591,ENSG00000092054,ENSG00000105649,ENSG00000181458,ENSG00000130176,ENSG00000111341,ENSG00000196218,ENSG00000186847,ENSG00000079215,ENSG00000174564,ENSG00000077522,ENSG00000198959,ENSG00000138207,ENSG00000115414,ENSG00000268751,ENSG00000076864,ENSG00000198125,ENSG00000121769,ENSG00000137077,ENSG00000106624,ENSG00000063180,ENSG00000225972,ENSG00000165887
ENSG00000169692,ENSG00000131398,ENSG00000223609,ENSG00000168878,ENSG00000196091,ENSG00000203785,ENSG00000211899,ENSG00000164816,ENSG00000169908,ENSG00000105825,ENSG00000136826,ENSG00000121900,ENSG00000087086,ENSG00000105290,ENSG00000119535,ENSG00000087086,ENSG00000125780,ENSG00000169469,ENSG00000249007,ENSG00000178531,ENSG00000128944,ENSG00000172403,ENSG00000125780,ENSG00000117472,ENSG00000213654,ENSG00000123975,ENSG00000112303,ENSG00000156299,ENSG00000164309,ENSG00000100604,ENSG00000143753,ENSG00000119681,ENSG00000172164,ENSG00000173991,ENSG00000161634,ENSG00000154146,ENSG00000203782,ENSG00000165887,ENSG00000110876,ENSG00000162444,ENSG00000168615,ENSG00000105427,ENSG00000232442,ENSG00000101470,ENSG00000078114,ENSG00000172724,ENSG00000129991,ENSG00000108821,ENSG00000175445,ENSG00000129170
ENSG00000211899,ENSG00000101670,ENSG00000188404,ENSG00000187266,ENSG00000143318,ENSG00000137699,ENSG00000136160,ENSG00000007312,ENSG00000076706,ENSG00000116774,ENSG00000149591,ENSG00000181885,ENSG00000129244,ENSG00000087086,ENSG00000167588,ENSG00000188257,ENSG00000134531,ENSG00000121552,ENSG00000172023,ENSG00000221946,ENSG00000025423,ENSG00000077157,ENSG00000167656,ENSG00000111057,ENSG00000104951,ENSG00000107984,ENSG00000188404,ENSG00000167964,ENSG00000101210,ENSG00000173110,ENSG00000244617,ENSG00000143248,ENSG00000162522,ENSG00000182676,ENSG00000137699,ENSG00000184524,ENSG00000042832,ENSG00000121577,ENSG00000140678,ENSG00000134339,ENSG00000164761,ENSG00000161249,ENSG00000101670,ENSG00000130595,ENSG00000010282,ENSG00000154553,ENSG00000155657,ENSG00000108691,ENSG00000138207,ENSG00000068976
ENSG00000211679,ENSG00000100084,ENSG00000143110,ENSG00000205336,ENSG00000086967,ENSG00000178934,ENSG00000198959,ENSG00000211772,ENSG00000135218,ENSG00000137309,ENSG00000175445,ENSG00000149418,ENSG00000178531,ENSG00000020129,ENSG00000135218,ENSG00000169418,ENSG00000164687,ENSG00000205420,ENSG00000125618,ENSG00000160781,ENSG00000169439,ENSG00000116741,ENSG00000175793,ENSG00000164266,ENSG00000157601,ENSG00000160886,ENSG00000087086,ENSG00000185615,ENSG00000197616,ENSG00000119888,ENSG00000186847,ENSG00000125868,ENSG00000213088,ENSG00000111245,ENSG00000081277,ENSG00000129244,ENSG00000115380,ENSG00000258444,ENSG00000018280,ENSG00000062282,ENSG00000168542,ENSG00000175315,ENSG00000100084,ENSG00000172399,ENSG00000108556,ENSG00000140545,ENSG00000101210,ENSG00000167972,ENSG00000205362,ENSG00000148677
ENSG00000008394,ENSG00000128944,ENSG00000128340,ENSG00000177464,ENSG00000170290,ENSG00000204421,ENSG00000169692,ENSG00000185133,ENSG00000120049,ENSG00000130635,ENSG00000119630,ENSG00000135052,ENSG00000166922,ENSG00000130203,ENSG00000077984,ENSG00000168743,ENSG00000136689,ENSG00000161249,ENSG00000181885,ENSG00000124920,ENSG00000269609,ENSG00000111696,ENSG00000135046,ENSG00000128298,ENSG00000162511,ENSG00000168542,ENSG00000011600,ENSG00000183036,ENSG00000131730,ENSG00000186907,ENSG00000169991,ENSG00000186340,ENSG00000168542,ENSG00000156885,ENSG00000188508,ENSG00000021300,ENSG00000181458,ENSG00000239474,ENSG00000066336,ENSG00000145824,ENSG00000111799,ENSG00000204421,ENSG00000158106,ENSG00000077522,ENSG00000198125,ENSG00000124225,ENSG00000188783,ENSG00000087086,ENSG00000123342,ENSG00000136717
ENSG00000172724,ENSG00000168878,ENSG00000143546,ENSG00000172164,ENSG00000239474,ENSG00000186395,ENSG00000167676,ENSG00000111341,ENSG00000175206,ENSG00000170017,ENSG00000118849,ENSG00000073350,ENSG00000106976,ENSG00000050165,ENSG00000188536,ENSG00000197766,ENSG00000165474,ENSG00000178934,ENSG00000117472,ENSG00000125814,ENSG00000115705,ENSG00000143248,ENSG00000143556,ENSG00000066230,ENSG00000187608,ENSG00000188643,ENSG00000187116,ENSG00000076864,ENSG00000158022,ENSG00000132821,ENSG00000105427,ENSG00000115414,ENSG00000140545,ENSG00000164309,ENSG00000039068,ENSG00000168913,ENSG00000203785,ENSG00000104879,ENSG00000119535,ENSG00000184113,ENSG00000144810,ENSG00000114270,ENSG00000128944,ENSG00000180209,ENSG00000166831,ENSG00000038427,ENSG00000077009,ENSG00000197119,ENSG00000176485,ENSG00000240045
ENSG00000157110,ENSG00000179832,ENSG00000180353,ENSG00000152804,ENSG00000164879,ENSG00000175315,ENSG00000099864,ENSG00000170323,ENSG00000211675,ENSG00000120708,ENSG00000184113,ENSG00000135916,ENSG00000168993,ENSG00000168309,ENSG00000008516,ENSG00000162444,ENSG00000148346,ENSG00000112378,ENSG00000211677,ENSG00000130294,ENSG00000243708,ENSG00000135269,ENSG00000165474,ENSG00000014914,ENSG00000143546,ENSG00000183160,ENSG00000103569,ENSG00000130203,ENSG00000134571,ENSG00000213983,ENSG00000133710,ENSG00000077943,ENSG00000145423,ENSG00000180209,ENSG00000165272,ENSG00000063180,ENSG00000137801,ENSG00000101470,ENSG00000170323,ENSG00000167588,ENSG00000115380,ENSG00000171346,ENSG00000173334,ENSG00000120729,ENSG00000120049,ENSG00000162772,ENSG00000138100,ENSG00000225972,ENSG00000167588,ENSG00000105048
ENSG00000197696,ENSG00000140263,ENSG00000100504,ENSG00000114737,ENSG00000111245,ENSG00000143556,ENSG00000166819,ENSG00000090104,ENSG00000163710,ENSG00000107984,ENSG00000087086,ENSG00000052344,ENSG00000127561,ENSG00000132535,ENSG00000185201,ENSG00000125618,ENSG00000228314,ENSG00000168925,ENSG00000175793,ENSG00000154277,ENSG00000119630,ENSG00000135842,ENSG00000172005,ENSG00000120756,ENSG00000111335,ENSG00000176890,ENSG00000105374,ENSG00000115705,ENSG00000145730,ENSG00000111674,ENSG00000175315,ENSG00000140092,ENSG00000108551,ENSG00000092054,ENSG00000052344,ENSG00000163032,ENSG00000178372,ENSG00000121769,ENSG00000259384,ENSG00000167772,ENSG00000116774,ENSG00000081277,ENSG00000140263,ENSG00000143318,ENSG00000198959,ENSG00000166819,ENSG00000129170,ENSG00000119699,ENSG00000167772,ENSG00000143549
ENSG00000133392,ENSG00000158106,ENSG00000185201,ENSG00000105443,ENSG00000185482,ENSG00000161249,ENSG00000169710,ENSG00000115705,ENSG00000169116,ENSG00000183160,ENSG00000111341,ENSG00000176153,ENSG00000131095,ENSG00000021300,ENSG00000105374,ENSG00000185201,ENSG00000169509,ENSG00000178363,ENSG00000115386,ENSG00000063180,ENSG00000183397,ENSG00000101447,ENSG00000169509,ENSG00000142959,ENSG00000211897,ENSG00000175063,ENSG00000008516,ENSG00000135046,ENSG00000239474,ENSG00000158106,ENSG00000204421,ENSG00000162998,ENSG00000125618,ENSG00000172403,ENSG00000126233,ENSG00000116661,ENSG00000115705,ENSG00000173991,ENSG00000167641,ENSG00000251322,ENSG00000166923,ENSG00000186081,ENSG00000179832,ENSG00000068976,ENSG00000172399,ENSG00000072163,ENSG00000153531,ENSG00000111341,ENSG00000088882,ENSG00000086967
