Topic 1,Topic 2,Topic 3,Topic 4,Topic 5,Topic 6,Topic 7,Topic 8
ENSG00000175206,ENSG00000111245,ENSG00000244734,ENSG00000133392,ENSG00000111245,ENSG00000186395,ENSG00000042832,ENSG00000115414
ENSG00000171401,ENSG00000105048,ENSG00000188536,ENSG00000149591,ENSG00000114854,ENSG00000167768,ENSG00000211895,ENSG00000163661
ENSG00000170477,ENSG00000104879,ENSG00000223609,ENSG00000163017,ENSG00000198125,ENSG00000186847,ENSG00000170323,ENSG00000108821
ENSG00000163209,ENSG00000092054,ENSG00000206172,ENSG00000111341,ENSG00000092054,ENSG00000172867,ENSG00000211890,ENSG00000120708
ENSG00000106631,ENSG00000114854,ENSG00000163221,ENSG00000130176,ENSG00000160808,ENSG00000188508,ENSG00000131095,ENSG00000164692
ENSG00000143536,ENSG00000164879,ENSG00000239839,ENSG00000159176,ENSG00000173991,ENSG00000178372,ENSG00000197971,ENSG00000107984
ENSG00000120937,ENSG00000168530,ENSG00000119535,ENSG00000125868,ENSG00000156885,ENSG00000203782,ENSG00000160180,ENSG00000196549
ENSG00000140519,ENSG00000148677,ENSG00000077984,ENSG00000115414,ENSG00000105048,ENSG00000161634,ENSG00000115705,ENSG00000106366
ENSG00000197616,ENSG00000159173,ENSG00000162747,ENSG00000106624,ENSG00000104879,ENSG00000178934,ENSG00000211896,ENSG00000137801
ENSG00000198336,ENSG00000112096,ENSG00000171051,ENSG00000076706,ENSG00000077522,ENSG00000189001,ENSG00000125618,ENSG00000148926
ENSG00000241794,ENSG00000077522,ENSG00000163464,ENSG00000143248,ENSG00000164879,ENSG00000161249,ENSG00000171747,ENSG00000163359
ENSG00000160213,ENSG00000101210,ENSG00000188404,ENSG00000049540,ENSG00000131730,ENSG00000204421,ENSG00000132639,ENSG00000106333
ENSG00000205420,ENSG00000129170,ENSG00000185201,ENSG00000140545,ENSG00000118194,ENSG00000205420,ENSG00000087250,ENSG00000105825
ENSG00000121552,ENSG00000165887,ENSG00000090382,ENSG00000188783,ENSG00000159173,ENSG00000244617,ENSG00000211675,ENSG00000174807
ENSG00000169474,ENSG00000198125,ENSG00000112303,ENSG00000167641,ENSG00000159251,ENSG00000112378,ENSG00000162896,ENSG00000166825
ENSG00000172005,ENSG00000125414,ENSG00000187116,ENSG00000182253,ENSG00000174437,ENSG00000186081,ENSG00000132465,ENSG00000164932
ENSG00000125780,ENSG00000077009,ENSG00000008516,ENSG00000136999,ENSG00000168530,ENSG00000081277,ENSG00000211899,ENSG00000103888
ENSG00000159251,ENSG00000172403,ENSG00000011600,ENSG00000115457,ENSG00000122367,ENSG00000172551,ENSG00000119888,ENSG00000091986
ENSG00000186081,ENSG00000143318,ENSG00000163563,ENSG00000171223,ENSG00000148677,ENSG00000175315,ENSG00000130203,ENSG00000049323
ENSG00000135046,ENSG00000124701,ENSG00000105374,ENSG00000065534,ENSG00000121769,ENSG00000169474,ENSG00000211677,ENSG00000197766
ENSG00000143369,ENSG00000177791,ENSG00000158869,ENSG00000198959,ENSG00000165887,ENSG00000096696,ENSG00000155980,ENSG00000113083
