Topic 1
ENSG00000251322
ENSG00000232810
ENSG00000224389
ENSG00000244731
ENSG00000243649
ENSG00000166278
ENSG00000204388
ENSG00000204421
ENSG00000204472
ENSG00000204482
ENSG00000227507
ENSG00000226979
ENSG00000227766
ENSG00000206337
ENSG00000271581
ENSG00000227939
ENSG00000206344
ENSG00000137310
ENSG00000204580
ENSG00000137331
ENSG00000224328
