Topic 1,Topic 2,Topic 3,Topic 4,Topic 5,Topic 6,Topic 7
ENSG00000151033,ENSG00000172399,ENSG00000203942,ENSG00000211648,ENSG00000188100,ENSG00000229105,ENSG00000234962
ENSG00000261683,ENSG00000248431,ENSG00000227234,ENSG00000211947,ENSG00000186832,ENSG00000228714,ENSG00000148377
ENSG00000271220,ENSG00000151005,ENSG00000147378,ENSG00000224650,ENSG00000226145,ENSG00000233516,ENSG00000204007
ENSG00000232624,ENSG00000251283,ENSG00000166917,ENSG00000211660,ENSG00000185479,ENSG00000230601,ENSG00000279935
ENSG00000241621,ENSG00000278880,ENSG00000138483,ENSG00000211934,ENSG00000167754,ENSG00000204193,ENSG00000242042
ENSG00000120563,ENSG00000251249,ENSG00000166796,ENSG00000211938,ENSG00000125780,ENSG00000148156,ENSG00000160349
ENSG00000235824,ENSG00000251688,ENSG00000267857,ENSG00000211904,ENSG00000143556,ENSG00000187003,ENSG00000122133
ENSG00000148513,ENSG00000234828,ENSG00000130377,ENSG00000270550,ENSG00000163216,ENSG00000226825,ENSG00000170827
ENSG00000237986,ENSG00000248809,ENSG00000198033,ENSG00000211651,ENSG00000131746,ENSG00000155833,ENSG00000162843
ENSG00000226304,ENSG00000248764,ENSG00000185594,ENSG00000105369,ENSG00000170423,ENSG00000234692,ENSG00000279774
ENSG00000234296,ENSG00000249317,ENSG00000141316,ENSG00000211945,ENSG00000043039,ENSG00000228174,ENSG00000230015
ENSG00000271360,ENSG00000109424,ENSG00000147081,ENSG00000211966,ENSG00000134762,ENSG00000230262,ENSG00000274121
ENSG00000223601,ENSG00000251024,ENSG00000186075,ENSG00000211662,ENSG00000188505,ENSG00000236763,ENSG00000225919
ENSG00000235410,ENSG00000260303,ENSG00000234186,ENSG00000211956,ENSG00000205076,ENSG00000234502,ENSG00000217327
ENSG00000228636,ENSG00000170180,ENSG00000270806,ENSG00000211955,ENSG00000134760,ENSG00000230328,ENSG00000236244
ENSG00000231976,ENSG00000248307,ENSG00000139351,ENSG00000211937,ENSG00000166535,ENSG00000232843,ENSG00000227043
ENSG00000252621,ENSG00000250341,ENSG00000180424,ENSG00000211640,ENSG00000137440,ENSG00000235601,ENSG00000180549
ENSG00000240800,ENSG00000205301,ENSG00000101448,ENSG00000211659,ENSG00000167759,ENSG00000229613,ENSG00000185888
ENSG00000244402,ENSG00000237136,ENSG00000124196,ENSG00000211943,ENSG00000057149,ENSG00000136881,ENSG00000188460
,ENSG00000250361,ENSG00000274391,ENSG00000224373,ENSG00000134757,ENSG00000227148,ENSG00000225334
,ENSG00000246876,ENSG00000267579,ENSG00000253755,ENSG00000087128,ENSG00000219073,ENSG00000174460
,ENSG00000261166,ENSG00000228075,ENSG00000211964,ENSG00000175121,ENSG00000142615,
,ENSG00000280262,ENSG00000105679,ENSG00000211941,ENSG00000197641,ENSG00000187730,
,,ENSG00000166118,,,ENSG00000162438,
,,ENSG00000176256,,,,
