Topic 1,Topic 2,Topic 3,Topic 4,Topic 5,Topic 6,Topic 7,Topic 8,Topic 9,Topic 10,Topic 11,Topic 12,Topic 13,Topic 14,Topic 15,Topic 16,Topic 17,Topic 18,Topic 19,Topic 20,Topic 21,Topic 22,Topic 23,Topic 24,Topic 25,Topic 26,Topic 27,Topic 28,Topic 29,Topic 30,Topic 31,Topic 32
ENSG00000115758,ENSG00000117450,ENSG00000009307,ENSG00000160213,ENSG00000009307,ENSG00000186395,ENSG00000220205,ENSG00000115541,ENSG00000136942,ENSG00000137409,ENSG00000143878,ENSG00000184840,ENSG00000185624,ENSG00000118705,ENSG00000157514,ENSG00000118181,ENSG00000101439,ENSG00000140416,ENSG00000177156,ENSG00000143549,ENSG00000115484,ENSG00000148834,ENSG00000111640,ENSG00000186395,ENSG00000111640,ENSG00000122406,ENSG00000198034,ENSG00000132589,ENSG00000125534,ENSG00000089009,ENSG00000171858,ENSG00000100129
ENSG00000022840,ENSG00000166848,ENSG00000101182,ENSG00000213339,ENSG00000179218,ENSG00000143753,ENSG00000125648,ENSG00000013306,ENSG00000137154,ENSG00000141232,ENSG00000105701,ENSG00000108298,ENSG00000172354,ENSG00000165458,ENSG00000108298,ENSG00000186395,ENSG00000108654,ENSG00000142541,ENSG00000013306,ENSG00000010256,ENSG00000140577,ENSG00000122884,ENSG00000005022,ENSG00000143753,ENSG00000137154,ENSG00000142192,ENSG00000196262,ENSG00000105835,ENSG00000128595,ENSG00000035141,ENSG00000111640,ENSG00000111640
ENSG00000156467,ENSG00000143621,ENSG00000084754,ENSG00000174444,ENSG00000085719,ENSG00000178585,ENSG00000122218,ENSG00000105701,ENSG00000106628,ENSG00000063046,ENSG00000108654,ENSG00000241878,ENSG00000146278,ENSG00000089220,ENSG00000062485,ENSG00000111640,ENSG00000105193,ENSG00000161960,ENSG00000149923,ENSG00000150991,ENSG00000109083,ENSG00000111640,ENSG00000105835,ENSG00000157557,ENSG00000136810,ENSG00000111640,ENSG00000254772,ENSG00000177156,ENSG00000171858,ENSG00000178035,ENSG00000136942,ENSG00000078668
ENSG00000163702,ENSG00000125877,ENSG00000122299,ENSG00000265681,ENSG00000183726,ENSG00000139433,ENSG00000189241,ENSG00000117298,ENSG00000100364,ENSG00000170027,ENSG00000136938,ENSG00000105193,ENSG00000148824,ENSG00000121691,ENSG00000189043,ENSG00000161547,ENSG00000099797,ENSG00000074800,ENSG00000111229,ENSG00000122477,ENSG00000168283,ENSG00000123416,ENSG00000005893,ENSG00000140416,ENSG00000185896,ENSG00000170606,ENSG00000074800,ENSG00000108518,ENSG00000143384,ENSG00000111726,ENSG00000132507,ENSG00000123416
ENSG00000140416,ENSG00000148303,ENSG00000197586,ENSG00000140943,ENSG00000198677,ENSG00000254772,ENSG00000143537,ENSG00000162434,ENSG00000148303,ENSG00000071127,ENSG00000117984,ENSG00000111640,ENSG00000160213,ENSG00000254772,ENSG00000132589,ENSG00000101439,ENSG00000073921,ENSG00000128272,ENSG00000105701,ENSG00000108298,ENSG00000121671,ENSG00000175166,ENSG00000108518,ENSG00000178585,ENSG00000101182,ENSG00000105193,ENSG00000140416,ENSG00000013306,ENSG00000149428,ENSG00000117691,ENSG00000186395,ENSG00000117318
ENSG00000166471,ENSG00000131507,ENSG00000114686,ENSG00000144381,ENSG00000239779,ENSG00000137154,ENSG00000111640,ENSG00000144659,ENSG00000105193,ENSG00000198561,ENSG00000111640,ENSG00000084652,ENSG00000120725,ENSG00000105193,ENSG00000105193,ENSG00000067182,ENSG00000147202,ENSG00000135404,ENSG00000064932,ENSG00000138495,ENSG00000164733,ENSG00000148248,ENSG00000013306,ENSG00000139433,ENSG00000172830,ENSG00000148303,ENSG00000072274,ENSG00000134686,ENSG00000136942,ENSG00000099331,ENSG00000164924,ENSG00000254772
ENSG00000142541,ENSG00000044574,ENSG00000166333,ENSG00000071127,ENSG00000115415,ENSG00000136942,ENSG00000113282,ENSG00000161970,ENSG00000058799,ENSG00000068697,ENSG00000108518,ENSG00000125691,ENSG00000161013,ENSG00000136240,ENSG00000087460,ENSG00000130402,ENSG00000115738,ENSG00000073578,ENSG00000141522,ENSG00000198721,ENSG00000157593,ENSG00000071082,ENSG00000165732,ENSG00000163472,ENSG00000110108,ENSG00000083845,ENSG00000134308,ENSG00000159128,ENSG00000134291,ENSG00000002549,ENSG00000099797,ENSG00000101290
ENSG00000108107,ENSG00000128159,ENSG00000111640,ENSG00000039650,ENSG00000100632,ENSG00000119862,ENSG00000197150,ENSG00000142541,ENSG00000154767,ENSG00000150991,ENSG00000166974,ENSG00000125124,ENSG00000103479,ENSG00000179222,ENSG00000086061,ENSG00000156467,ENSG00000213625,ENSG00000064932,ENSG00000143878,ENSG00000100442,ENSG00000167085,ENSG00000073578,ENSG00000117410,ENSG00000108578,ENSG00000140416,ENSG00000004779,ENSG00000008710,ENSG00000185883,ENSG00000140612,ENSG00000137817,ENSG00000133265,ENSG00000168000
ENSG00000111640,ENSG00000160285,ENSG00000108298,ENSG00000169813,ENSG00000203879,ENSG00000163472,ENSG00000137154,ENSG00000100225,ENSG00000179041,ENSG00000068323,ENSG00000168899,ENSG00000175550,ENSG00000132432,ENSG00000143368,ENSG00000133606,ENSG00000143753,ENSG00000159140,ENSG00000107581,ENSG00000167775,ENSG00000160299,ENSG00000051108,ENSG00000148672,ENSG00000067955,ENSG00000233276,ENSG00000068745,ENSG00000122515,ENSG00000081154,ENSG00000113732,ENSG00000219200,ENSG00000140416,ENSG00000163660,ENSG00000051108
ENSG00000180957,ENSG00000108518,ENSG00000131828,ENSG00000132356,ENSG00000181789,ENSG00000108578,ENSG00000133030,ENSG00000100201,ENSG00000115875,ENSG00000172845,ENSG00000135164,ENSG00000160691,ENSG00000132589,ENSG00000162231,ENSG00000105953,ENSG00000073578,ENSG00000181904,ENSG00000185624,ENSG00000178127,ENSG00000105193,ENSG00000163902,ENSG00000114416,ENSG00000072274,ENSG00000119862,ENSG00000221978,ENSG00000262814,ENSG00000004534,ENSG00000171552,ENSG00000125691,ENSG00000005206,ENSG00000089902,ENSG00000148303
ENSG00000182004,ENSG00000188895,ENSG00000047849,ENSG00000115738,ENSG00000132646,ENSG00000198034,ENSG00000184207,ENSG00000101160,ENSG00000001497,ENSG00000162613,ENSG00000167969,ENSG00000173226,ENSG00000125534,ENSG00000167193,ENSG00000136942,ENSG00000185883,ENSG00000128159,ENSG00000143162,ENSG00000132589,ENSG00000166441,ENSG00000165792,ENSG00000104408,ENSG00000132589,ENSG00000143537,ENSG00000221988,ENSG00000133606,ENSG00000111897,ENSG00000172354,ENSG00000111640,ENSG00000171298,ENSG00000174444,ENSG00000101363
ENSG00000059122,ENSG00000196230,ENSG00000167470,ENSG00000134884,ENSG00000198833,ENSG00000175416,ENSG00000117868,ENSG00000132635,ENSG00000153914,ENSG00000049245,ENSG00000100764,ENSG00000132670,ENSG00000115053,ENSG00000159086,ENSG00000186468,ENSG00000157514,ENSG00000123416,ENSG00000180817,ENSG00000013441,ENSG00000196535,ENSG00000149136,ENSG00000182768,ENSG00000164039,ENSG00000179091,ENSG00000167114,ENSG00000150753,ENSG00000084234,ENSG00000044574,ENSG00000161970,ENSG00000141994,ENSG00000049656,ENSG00000203879
ENSG00000141030,ENSG00000067167,ENSG00000086015,ENSG00000110422,ENSG00000119950,ENSG00000083845,ENSG00000096080,ENSG00000156261,ENSG00000182220,ENSG00000138674,ENSG00000130522,ENSG00000152684,ENSG00000125691,ENSG00000177119,ENSG00000142541,ENSG00000101160,ENSG00000144749,ENSG00000117592,ENSG00000179218,ENSG00000147684,ENSG00000122406,ENSG00000146701,ENSG00000131069,ENSG00000141503,ENSG00000196743,ENSG00000148672,ENSG00000111640,ENSG00000136280,ENSG00000138050,ENSG00000139718,ENSG00000196199,ENSG00000068305
ENSG00000179091,ENSG00000163472,ENSG00000175550,ENSG00000100201,ENSG00000125821,ENSG00000069667,ENSG00000125691,ENSG00000122406,ENSG00000102977,ENSG00000101158,ENSG00000253729,ENSG00000120697,ENSG00000144895,ENSG00000005022,ENSG00000105677,ENSG00000108518,ENSG00000008710,ENSG00000145907,ENSG00000110651,ENSG00000064545,ENSG00000148484,ENSG00000178719,ENSG00000146701,ENSG00000172594,ENSG00000173418,ENSG00000104805,ENSG00000140450,ENSG00000087157,ENSG00000100075,ENSG00000243927,ENSG00000114942,ENSG00000137154
ENSG00000140990,ENSG00000101457,ENSG00000181789,ENSG00000071537,ENSG00000110651,ENSG00000142541,ENSG00000105223,ENSG00000172340,ENSG00000170027,ENSG00000178685,ENSG00000115306,ENSG00000118181,ENSG00000136156,ENSG00000107175,ENSG00000092036,ENSG00000117984,ENSG00000105438,ENSG00000101444,ENSG00000198925,ENSG00000078668,ENSG00000142541,ENSG00000132361,ENSG00000159346,ENSG00000101439,ENSG00000075914,ENSG00000204392,ENSG00000134333,ENSG00000169826,ENSG00000044115,ENSG00000110090,ENSG00000124155,ENSG00000130826
ENSG00000108848,ENSG00000165806,ENSG00000241685,ENSG00000166333,ENSG00000084112,ENSG00000072210,ENSG00000182154,ENSG00000164054,ENSG00000189266,ENSG00000182220,ENSG00000142541,ENSG00000089220,ENSG00000173726,ENSG00000116688,ENSG00000269858,ENSG00000198931,ENSG00000115421,ENSG00000119138,ENSG00000101199,ENSG00000068903,ENSG00000106077,ENSG00000005022,ENSG00000122477,ENSG00000089220,ENSG00000168003,ENSG00000101361,ENSG00000142541,ENSG00000188895,ENSG00000165476,ENSG00000122218,ENSG00000185896,ENSG00000182685
ENSG00000046651,ENSG00000156261,ENSG00000124151,ENSG00000111912,ENSG00000204386,ENSG00000188186,ENSG00000067836,ENSG00000124198,ENSG00000177889,ENSG00000138095,ENSG00000148303,ENSG00000233276,ENSG00000157557,ENSG00000110651,ENSG00000219200,ENSG00000064726,ENSG00000144867,ENSG00000135926,ENSG00000146828,ENSG00000125166,ENSG00000101444,ENSG00000213585,ENSG00000110651,ENSG00000137409,ENSG00000101361,ENSG00000164405,ENSG00000180891,ENSG00000101152,ENSG00000126524,ENSG00000083845,ENSG00000159346,ENSG00000143570
ENSG00000221978,ENSG00000150991,ENSG00000173726,ENSG00000139636,ENSG00000128595,ENSG00000171858,ENSG00000182568,ENSG00000103978,ENSG00000237651,ENSG00000053900,ENSG00000196743,ENSG00000237651,ENSG00000265681,ENSG00000112667,ENSG00000102054,ENSG00000139433,ENSG00000152492,ENSG00000010322,ENSG00000111640,ENSG00000072778,ENSG00000112511,ENSG00000173457,ENSG00000104221,ENSG00000141232,ENSG00000244038,ENSG00000162368,ENSG00000156171,ENSG00000172331,ENSG00000143013,ENSG00000161970,ENSG00000163472,ENSG00000163328
ENSG00000167074,ENSG00000136810,ENSG00000139168,ENSG00000123091,ENSG00000181222,ENSG00000108298,ENSG00000117318,ENSG00000109171,ENSG00000171988,ENSG00000151176,ENSG00000139433,ENSG00000168710,ENSG00000166340,ENSG00000160877,ENSG00000103769,ENSG00000120265,ENSG00000241685,ENSG00000135002,ENSG00000196182,ENSG00000114770,ENSG00000065057,ENSG00000100902,ENSG00000027697,ENSG00000087460,ENSG00000119787,ENSG00000254772,ENSG00000132661,ENSG00000146278,ENSG00000129636,ENSG00000186187,ENSG00000118985,ENSG00000135924
ENSG00000099901,ENSG00000119655,ENSG00000091527,ENSG00000111640,ENSG00000162302,ENSG00000141503,ENSG00000100911,ENSG00000131507,ENSG00000181163,ENSG00000113971,ENSG00000114735,ENSG00000083845,ENSG00000170027,ENSG00000150403,ENSG00000005882,ENSG00000148303,ENSG00000160213,ENSG00000242259,ENSG00000167797,ENSG00000189043,ENSG00000005206,ENSG00000141030,ENSG00000004534,ENSG00000085117,ENSG00000166912,ENSG00000123595,ENSG00000146223,ENSG00000082146,ENSG00000158526,ENSG00000142541,ENSG00000160710,ENSG00000115504
ENSG00000182220,ENSG00000115091,ENSG00000136045,ENSG00000135446,ENSG00000008952,ENSG00000157557,ENSG00000091140,ENSG00000164733,ENSG00000141232,ENSG00000100804,ENSG00000122565,ENSG00000177156,ENSG00000172725,ENSG00000118181,ENSG00000119977,ENSG00000129219,ENSG00000148411,ENSG00000265681,ENSG00000139613,ENSG00000119421,ENSG00000111640,ENSG00000108829,ENSG00000022840,ENSG00000010256,ENSG00000125691,ENSG00000170144,ENSG00000105887,ENSG00000130830,ENSG00000145860,ENSG00000107175,ENSG00000115484,ENSG00000067369
