Topic 1,Topic 2,Topic 3,Topic 4,Topic 5,Topic 6,Topic 7,Topic 8,Topic 9,Topic 10,Topic 11,Topic 12,Topic 13,Topic 14,Topic 15,Topic 16,Topic 17,Topic 18,Topic 19,Topic 20,Topic 21,Topic 22,Topic 23,Topic 24,Topic 25,Topic 26,Topic 27,Topic 28,Topic 29,Topic 30,Topic 31
ENSG00000137309,ENSG00000198668,ENSG00000188581,ENSG00000211445,ENSG00000105369,ENSG00000121769,ENSG00000188536,ENSG00000160781,ENSG00000159516,ENSG00000143248,ENSG00000105369,ENSG00000132465,ENSG00000188536,ENSG00000188536,ENSG00000211445,ENSG00000188536,ENSG00000121769,ENSG00000143248,ENSG00000211445,ENSG00000172201,ENSG00000133392,ENSG00000211445,ENSG00000154146,ENSG00000211445,ENSG00000004799,ENSG00000203786,ENSG00000211445,ENSG00000133392,ENSG00000133392,ENSG00000132465,ENSG00000143416
ENSG00000020129,ENSG00000227051,ENSG00000006059,ENSG00000130595,ENSG00000105246,ENSG00000130595,ENSG00000154146,ENSG00000021300,ENSG00000163207,ENSG00000133392,ENSG00000115956,ENSG00000137309,ENSG00000173868,ENSG00000012779,ENSG00000082641,ENSG00000141480,ENSG00000107317,ENSG00000187479,ENSG00000131386,ENSG00000071967,ENSG00000182253,ENSG00000196616,ENSG00000160781,ENSG00000143742,ENSG00000159516,ENSG00000159516,ENSG00000004799,ENSG00000164949,ENSG00000171431,ENSG00000143416,ENSG00000171431
ENSG00000166888,ENSG00000128595,ENSG00000189169,ENSG00000159516,ENSG00000132465,ENSG00000125414,ENSG00000141480,ENSG00000154146,ENSG00000124107,ENSG00000077157,ENSG00000157601,ENSG00000244437,ENSG00000176978,ENSG00000180573,ENSG00000130595,ENSG00000271503,ENSG00000004799,ENSG00000213145,ENSG00000196616,ENSG00000172403,ENSG00000077157,ENSG00000257671,ENSG00000021300,ENSG00000143248,ENSG00000160781,ENSG00000143367,ENSG00000130595,ENSG00000184743,ENSG00000196616,ENSG00000244437,ENSG00000132465
ENSG00000143248,ENSG00000160781,ENSG00000203786,ENSG00000278978,ENSG00000005001,ENSG00000107317,ENSG00000115956,ENSG00000070808,ENSG00000163472,ENSG00000084234,ENSG00000105246,ENSG00000104894,ENSG00000142937,ENSG00000163162,ENSG00000187479,ENSG00000140932,ENSG00000133392,ENSG00000133392,ENSG00000164949,ENSG00000187479,ENSG00000197702,ENSG00000185432,ENSG00000020129,ENSG00000101230,ENSG00000203786,ENSG00000268751,ENSG00000130600,ENSG00000172403,ENSG00000137575,ENSG00000171431,ENSG00000145824
ENSG00000111669,ENSG00000071967,ENSG00000004799,ENSG00000187479,ENSG00000211905,ENSG00000004799,ENSG00000100055,ENSG00000020129,ENSG00000203786,ENSG00000198668,ENSG00000143416,ENSG00000115956,ENSG00000115956,ENSG00000198736,ENSG00000133392,ENSG00000015285,ENSG00000176978,ENSG00000167941,ENSG00000170989,ENSG00000110107,ENSG00000163297,ENSG00000101230,ENSG00000188536,ENSG00000187479,ENSG00000175826,ENSG00000119862,ENSG00000107537,ENSG00000077157,ENSG00000147872,ENSG00000211905,ENSG00000185624
ENSG00000173757,ENSG00000004799,ENSG00000196616,ENSG00000019995,ENSG00000244094,ENSG00000186439,ENSG00000163162,ENSG00000170775,ENSG00000186806,ENSG00000077782,ENSG00000115165,ENSG00000154165,ENSG00000163660,ENSG00000130066,ENSG00000133315,ENSG00000101307,ENSG00000150991,ENSG00000130037,ENSG00000172403,ENSG00000185432,ENSG00000114790,ENSG00000130066,ENSG00000102226,ENSG00000071967,ENSG00000130066,ENSG00000163207,ENSG00000147872,ENSG00000197702,ENSG00000143416,ENSG00000167434,ENSG00000159516
ENSG00000154146,ENSG00000100302,ENSG00000241233,ENSG00000104131,ENSG00000211445,ENSG00000125166,ENSG00000198736,ENSG00000187957,ENSG00000214711,ENSG00000151240,ENSG00000101230,ENSG00000196616,ENSG00000198736,ENSG00000137575,ENSG00000143248,ENSG00000071082,ENSG00000187479,ENSG00000049323,ENSG00000143248,ENSG00000131981,ENSG00000198753,ENSG00000130707,ENSG00000107317,ENSG00000188536,ENSG00000172403,ENSG00000189280,ENSG00000131386,ENSG00000242441,ENSG00000132465,ENSG00000095110,ENSG00000137309
ENSG00000185624,ENSG00000006468,ENSG00000268751,ENSG00000142937,ENSG00000124107,ENSG00000100412,ENSG00000137575,ENSG00000107317,ENSG00000145824,ENSG00000205795,ENSG00000154165,ENSG00000021300,ENSG00000140678,ENSG00000115165,ENSG00000204628,ENSG00000100055,ENSG00000049323,ENSG00000198668,ENSG00000187479,ENSG00000163660,ENSG00000166888,ENSG00000187266,ENSG00000187957,ENSG00000172757,ENSG00000111669,ENSG00000071082,ENSG00000144908,ENSG00000173068,ENSG00000050767,ENSG00000282639,ENSG00000204628
ENSG00000070808,ENSG00000159784,ENSG00000189280,ENSG00000268751,ENSG00000115956,ENSG00000082641,ENSG00000146828,ENSG00000124374,ENSG00000189280,ENSG00000096746,ENSG00000188536,ENSG00000159516,ENSG00000189067,ENSG00000076928,ENSG00000107537,ENSG00000012779,ENSG00000172403,ENSG00000232057,ENSG00000136859,ENSG00000132481,ENSG00000172403,ENSG00000028528,ENSG00000170775,ENSG00000172201,ENSG00000136695,ENSG00000087510,ENSG00000142937,ENSG00000077782,ENSG00000185432,ENSG00000183463,ENSG00000134057
ENSG00000049449,ENSG00000174996,ENSG00000170484,ENSG00000142669,ENSG00000244437,ENSG00000163126,ENSG00000100201,ENSG00000232560,ENSG00000172382,ENSG00000185624,ENSG00000131378,ENSG00000121900,ENSG00000023734,ENSG00000166900,ENSG00000069535,ENSG00000173868,ENSG00000128595,ENSG00000226409,ENSG00000101230,ENSG00000104870,ENSG00000084636,ENSG00000149968,ENSG00000137267,ENSG00000196616,ENSG00000185024,ENSG00000132475,ENSG00000172757,ENSG00000196616,ENSG00000137309,ENSG00000240671,ENSG00000154165
ENSG00000156860,ENSG00000188536,ENSG00000159516,ENSG00000137575,ENSG00000185624,ENSG00000134020,ENSG00000083845,ENSG00000148826,ENSG00000132475,ENSG00000182253,ENSG00000143742,ENSG00000134057,ENSG00000100201,ENSG00000140932,ENSG00000132475,ENSG00000130592,ENSG00000130595,ENSG00000188483,ENSG00000137575,ENSG00000131386,ENSG00000146374,ENSG00000105426,ENSG00000148826,ENSG00000004799,ENSG00000121900,ENSG00000131981,ENSG00000125414,ENSG00000143248,ENSG00000111669,ENSG00000121900,ENSG00000137804
ENSG00000006059,ENSG00000100412,ENSG00000182979,ENSG00000128595,ENSG00000214711,ENSG00000133878,ENSG00000130592,ENSG00000211445,ENSG00000143367,ENSG00000004799,ENSG00000160182,ENSG00000064270,ENSG00000198918,ENSG00000115956,ENSG00000091436,ENSG00000257335,ENSG00000167699,ENSG00000162591,ENSG00000279041,ENSG00000105568,ENSG00000112759,ENSG00000124216,ENSG00000211445,ENSG00000082641,ENSG00000185624,ENSG00000172403,ENSG00000186439,ENSG00000128709,ENSG00000167671,ENSG00000211972,ENSG00000147804
ENSG00000188581,ENSG00000170876,ENSG00000110717,ENSG00000142507,ENSG00000172382,ENSG00000178104,ENSG00000115165,ENSG00000137267,ENSG00000073282,ENSG00000172403,ENSG00000204305,ENSG00000105369,ENSG00000104894,ENSG00000167261,ENSG00000172757,ENSG00000130707,ENSG00000142937,ENSG00000069535,ENSG00000028528,ENSG00000147872,ENSG00000004799,ENSG00000105971,ENSG00000141480,ENSG00000124216,ENSG00000136986,ENSG00000196616,ENSG00000203883,ENSG00000132481,ENSG00000187479,ENSG00000147804,ENSG00000183463
ENSG00000049323,ENSG00000137309,ENSG00000145824,ENSG00000196616,ENSG00000271503,ENSG00000150991,ENSG00000160588,ENSG00000104112,ENSG00000188581,ENSG00000170876,ENSG00000167895,ENSG00000157601,ENSG00000125304,ENSG00000015285,ENSG00000185624,ENSG00000211445,ENSG00000110107,ENSG00000271833,ENSG00000142669,ENSG00000133392,ENSG00000160191,ENSG00000271941,ENSG00000104112,ENSG00000167680,ENSG00000119777,ENSG00000136695,ENSG00000196616,ENSG00000151240,ENSG00000156860,ENSG00000276566,ENSG00000160182
ENSG00000147872,ENSG00000172403,ENSG00000163207,ENSG00000163207,ENSG00000135720,ENSG00000174429,ENSG00000180596,ENSG00000102226,ENSG00000146904,ENSG00000213145,ENSG00000121769,ENSG00000115165,ENSG00000119777,ENSG00000257335,ENSG00000142669,ENSG00000124006,ENSG00000145824,ENSG00000120896,ENSG00000171604,ENSG00000121900,ENSG00000132481,ENSG00000131386,ENSG00000124374,ENSG00000142669,ENSG00000133392,ENSG00000104892,ENSG00000133315,ENSG00000114790,ENSG00000182253,ENSG00000225523,ENSG00000095110
ENSG00000004799,ENSG00000137312,ENSG00000157426,ENSG00000125414,ENSG00000108639,ENSG00000130600,ENSG00000076928,ENSG00000092964,ENSG00000087510,ENSG00000067900,ENSG00000107317,ENSG00000211445,ENSG00000167671,ENSG00000072786,ENSG00000050767,ENSG00000143416,ENSG00000140995,ENSG00000172403,ENSG00000234617,ENSG00000159516,ENSG00000147655,ENSG00000071967,ENSG00000092964,ENSG00000143554,ENSG00000211445,ENSG00000163472,ENSG00000175826,ENSG00000167941,ENSG00000095110,ENSG00000131981,ENSG00000115694
ENSG00000023734,ENSG00000091436,ENSG00000104892,ENSG00000174996,ENSG00000240671,ENSG00000078814,ENSG00000064012,ENSG00000142937,ENSG00000006059,ENSG00000152404,ENSG00000005206,ENSG00000163344,ENSG00000124222,ENSG00000146828,ENSG00000172403,ENSG00000145824,ENSG00000023734,ENSG00000260139,ENSG00000187266,ENSG00000213145,ENSG00000128709,ENSG00000260314,ENSG00000142937,ENSG00000028528,ENSG00000166888,ENSG00000106571,ENSG00000187479,ENSG00000067900,ENSG00000183291,ENSG00000160191,ENSG00000123737
ENSG00000163660,ENSG00000082641,ENSG00000244025,ENSG00000255026,ENSG00000104894,ENSG00000165912,ENSG00000173868,ENSG00000144369,ENSG00000136695,ENSG00000121769,ENSG00000118939,ENSG00000265415,ENSG00000131467,ENSG00000135334,ENSG00000124107,ENSG00000110696,ENSG00000077782,ENSG00000151491,ENSG00000124107,ENSG00000203883,ENSG00000279041,ENSG00000279382,ENSG00000144369,ENSG00000133392,ENSG00000071082,ENSG00000016402,ENSG00000187486,ENSG00000240990,ENSG00000132286,ENSG00000160182,ENSG00000244437
ENSG00000112759,ENSG00000167671,ENSG00000123143,ENSG00000131467,ENSG00000115165,ENSG00000111669,ENSG00000142937,ENSG00000159784,ENSG00000119862,ENSG00000269113,ENSG00000278978,ENSG00000144655,ENSG00000163162,ENSG00000154146,ENSG00000112992,ENSG00000143742,ENSG00000129757,ENSG00000269113,ENSG00000076928,ENSG00000203786,ENSG00000242441,ENSG00000172201,ENSG00000159784,ENSG00000204305,ENSG00000137309,ENSG00000073282,ENSG00000136859,ENSG00000185624,ENSG00000155506,ENSG00000254827,ENSG00000243989
ENSG00000135334,ENSG00000187479,ENSG00000083845,ENSG00000049323,ENSG00000184602,ENSG00000133315,ENSG00000073861,ENSG00000232859,ENSG00000001617,ENSG00000187479,ENSG00000134020,ENSG00000143416,ENSG00000122565,ENSG00000142937,ENSG00000010319,ENSG00000118418,ENSG00000101040,ENSG00000077782,ENSG00000134644,ENSG00000112640,ENSG00000142507,ENSG00000120896,ENSG00000140600,ENSG00000170989,ENSG00000142937,ENSG00000145824,ENSG00000178104,ENSG00000187479,ENSG00000169047,ENSG00000125304,ENSG00000064270
ENSG00000142669,ENSG00000133392,ENSG00000137309,ENSG00000132286,ENSG00000204628,ENSG00000187486,ENSG00000104915,ENSG00000140600,ENSG00000104892,ENSG00000136378,ENSG00000111412,ENSG00000133392,ENSG00000155508,ENSG00000142669,ENSG00000180185,ENSG00000134884,ENSG00000154146,ENSG00000248441,ENSG00000185624,ENSG00000130332,ENSG00000100201,ENSG00000132906,ENSG00000129244,ENSG00000134056,ENSG00000083845,ENSG00000188536,ENSG00000184602,ENSG00000279041,ENSG00000112759,ENSG00000173237,ENSG00000105246
