Topic 1
ENSG00000253951
ENSG00000267409
ENSG00000102401
ENSG00000164627
ENSG00000151576
ENSG00000283078
ENSG00000048991
ENSG00000137675
ENSG00000222448
ENSG00000179630
ENSG00000251996
ENSG00000100201
ENSG00000113492
ENSG00000207821
ENSG00000283972
ENSG00000188162
ENSG00000228078
ENSG00000132109
ENSG00000283673
ENSG00000258416
ENSG00000183246
